quitarse de en medio: achantar
apartarse: achantar
apártate: achanta
quítate: achanta
aparta: achanta
mucha cantidad: a dolor
mucho: a dolor
alcohol: Alpiste 
pagar: Aforar
Ensimismado: Atrapao
Desconcertado: atrapao
Bufar: Protestar 
Senos: Bufas
tetas: Bufas
pechos: Bufas
Trasero: Bul
culo: bul
Pelea: Bulla
Genial: bute
Descubrir: cachar
sorprender: cachar
Cubata: Cacharro
Porro: Calamar
saber: Chanar
Pesado: Chapas
Enfadarse: Chinarse
niño: Chinorri
niña: chinorri
Chico: Chorbo
tío: chorbo
chica: chorba
niña: chorbita
Perro:Chukel
Borracho: Chuzas
ebrio: chuzas
Emborracharse: Chuzarse
Tener sexo: Cotizar
Pegar: Cusmar
Sin tener que pagar: De gratis
gratis: de gratis
De casualidad: De pija 
de suerte: de pija
enorme: Del mil
Vomitar: Doblar
Funcionar: Fucar
De poco valor: Ful
Futbolín: Futbolas
Puñetazo: Galleto
Correr: Gambear
Cerveza: Garimba
Gasolina: Gasofa
Canutos: Grelos
porros: grelos
Loco: Grillao
Dinero: Guita
Novia: Ja
Comer: Jalar
Comida: Jalufa
Pelearse: Jumear
Mirar: Junar 
idiota: Julai
gilipollas: julai
Falso: de Juja
Casa: Kel
malote: kiote
Mentir: Kiar
mentira: kiada
practicar sexo: kilar
follar: kilar
despectivo: Kinito
truco: La trece catorce
jugarreta: La trece catorce
hacer novillos: Latar
gafas: Lelas
problema: Liada
lío: liada
sorprender: Ligar
Persona muy grande: Manguta
reirse: Mararse
sacrificado: matao
pringado: matao
Ligar: Matizar
besarse: Mazar
Persona musculosa: Mazas
cachas: mazas
quedarse calvo: Mondar
Movida: Muvi
suceso: muvi
nada: nel
poca disposición a hacer algo: Ni jarto grifa
persona(despectivo): notas
Mordisco: Ñaco
Clases particulares: Pasantía
suspender: pinzar
Piernas: Pencas
Genial : Perito
excelente: perita
Traidor: Perras
Peseto: taxista
Mujer joven y alegre: Pestrucha
lleno: Petado
abarrotado: petado
ceñido: petado
estropearse: Petar
sodomizar: Petar el bul
hastío: Pía
asco: Pía
aburrimiento: Pía
dormir: Piltrar
suspender: Pinzar
Ver: Pipear
descubrir: pipear
Caer en la cuenta: Pisparse
hermano: Plas
hermana: plasa
irresponsable: Prea
padre: puril
viejo: puril
madre: purila
vieja: purila
hacer algo bien: Puchar
vomitar: Rabar
Pasar algo: Rular 
funcionar: rular
paseo: Rule
moto: Runner
Librarse: Safar 
Emborracharse: Tajarse
Loco: Taladrao
Puñetazo: Truco
Cigarrillo: Truja
torpe: nécora
atontado: pirolo
miembro viril: pirola
pene: pirola
aldea: argolla
cotilla: lercha
lumi: prostituta
gitano: chacho
disimuladamente: destrangis
un euro: una libra
euro: libra
billete: boleto
policía: madera
mordisco: ñaco
ísimo: érrimo
ísima: érrima
comí: jalé
establecimiento: garito
movida: muvi
